020000200202
000010010000
000010000001
001100010001
001000200110
020000002000
110000000010
000000200010
020201010000
100001000000
202000001002
000000101000